18	  18    18    18    18    18    18    18    18    18    18    18    18    18    18    18    18    18    18    18    18    
21    21    35    35    35    35    35    35    35    35    35    35    35    35    35    35    35    35    35    35    35    
21    38    35    35    35    35    35    35    35    35    35    35    35    35    35    35    35    35    35    35    35    
21    102   103   103   103   103   103   103   103   103   103   103   103   103   103   103   103   103   103   103   103   
21    119   120   120   120   120   120   120   120   120   120   120   120   120   120   120   120   120   120   120   120   
21    119   120   120   120   120   120   120   120   120   120   120   120   120   120   120   120   120   120   120   120   
21    119   120   120   120   120   120   120   120   120   120   120   120   72    120   120   72    120   108   109   120   
21    119   120   120   120   120   120   120   120   120   120   120   120   120   120   120   120   120   125   126   120   
21    119   120   120   120   120   120   68	 68    68    68    120   120   120   120   120   120   120   68    70    120   
21    119   120   120   120   120   120   120   120   120   120   120   120   162   163   120   120   120   120   120   120   
38    119   120   120   120   72    120   120   120   120   120   120   120   72    180   120   120   120   120   120   120   
119   120   120   120   120   120   120   120   120   120   4     120   120   120   120   120   120   4     120   120   120   
119   120   120   120   72    120   120   120   120   120   21    120   120   120   120   120   120   21    120   120   120   
137   137   137   137   137   137   137   137   137   137   38    137   137   137   137   137   137   38    137   137   120    
1     1     1     1     1     1     1     1     1     1     1     1     1     1     1     1     1     1     1     1     119    
18    18    18    18    18    18    18    18    18    18    18    18    18    18    18    18    18    18    18    19    119    

